100007090
030020008
009600500
005000000
000203000
000000600
003006100
500010030
040000007