450000000
002070630
000000028
000950000
086000200
020600750
000000476
070045000
008009000