004300200
002600080
068300007
003001005
059060072
000520046
205906000
000408050
000007004