003020600
900305001
001806400
300000002
200803009
000000000
009201700
800602003
006000000