000400000
500010009
000000000
000000000
400000006
000000000
000000000
100060004
000200000